rank,title,world_gross,dom_gross,dom_perc,for_gr,for_perc,year
1,Avatar,2923706026,785221649,26.9,2138484377,73.1,2009
2,Avengers: Endgame,2799439100,858373000,30.7,1941066100,69.3,2019
3,Titanic,2194690964,659363944,30.0,1535327020,70.0,1997
4,Avatar: The Way of Water,2129714940,624614940,29.3,1505100000,70.7,2022
5,Star Wars: Episode VII - The Force Awakens,2071310218,936662225,45.2,1134647993,54.8,2015
6,Avengers: Infinity War,2052415039,678815482,33.1,1373599557,66.9,2018
7,Spider-Man: No Way Home,1921847111,814115070,42.4,1107732041,57.6,2021
8,Jurassic World,1671537444,653406625,39.1,1018130819,60.9,2015
9,The Lion King,1663075401,543638043,32.7,1119437358,67.3,2019
10,The Avengers,1520538536,623357910,41.0,897180626,59.0,2012
11,Furious 7,1515341399,353007020,23.3,1162334379,76.7,2015
12,Top Gun: Maverick,1488732821,718732821,48.3,770000000,51.7,2022
13,Frozen II,1453683476,477373578,32.8,976309898,67.2,2019
14,Avengers: Age of Ultron,1405018048,459005868,32.7,946012180,67.3,2015
15,Black Panther,1349926083,700426566,51.9,649499517,48.1,2018
16,Harry Potter and the Deathly Hallows: Part 2,1342359942,381447587,28.4,960912355,71.6,2011
17,Star Wars: Episode VIII - The Last Jedi,1334407706,620181382,46.5,714226324,53.5,2017
18,Jurassic World: Fallen Kingdom,1310466296,417719760,31.9,892746536,68.1,2018
19,Frozen,1284540518,400953009,31.2,883587509,68.8,2013
20,Beauty and the Beast,1266115964,504481165,39.8,761634799,60.2,2017
21,Incredibles 2,1243225667,608581744,49.0,634643923,51.0,2018
22,The Fate of the Furious,1236005118,226008385,18.3,1009996733,81.7,2017
23,Iron Man 3,1215577205,409013994,33.6,806563211,66.4,2013
24,Minions,1159444662,336045770,29.0,823398892,71.0,2015
25,Captain America: Civil War,1155046416,408084349,35.3,746962067,64.7,2016
26,Aquaman,1148528393,335104314,29.2,813424079,70.8,2018
27,The Lord of the Rings: The Return of the King,1146457748,378251207,33.0,768206541,67.0,2003
28,Spider-Man: Far from Home,1131927996,390532085,34.5,741395911,65.5,2019
29,Captain Marvel,1131416446,426829839,37.7,704586607,62.3,2019
30,Transformers: Dark of the Moon,1123794079,352390543,31.4,771403536,68.6,2011
31,Jurassic Park,1109802321,404214720,36.4,705587601,63.6,1993
32,Skyfall,1108569499,304360277,27.5,804209222,72.5,2012
33,Transformers: Age of Extinction,1104054072,245439076,22.2,858614996,77.8,2014
34,The Dark Knight Rises,1081169825,448149584,41.4,633020241,58.6,2012
35,Star Wars: Episode IX - The Rise of Skywalker,1077022372,515202542,47.8,561819830,52.2,2019
36,Joker,1074458282,335477657,31.2,738980625,68.8,2019
37,Toy Story 4,1073841394,434038008,40.4,639803386,59.6,2019
38,Toy Story 3,1067316101,415004880,38.9,652311221,61.1,2010
39,Pirates of the Caribbean: Dead Man's Chest,1066179747,423315812,39.7,642863935,60.3,2006
40,Rogue One: A Star Wars Story,1058682142,533539991,50.4,525142151,49.6,2016
41,Aladdin,1054304000,355559216,33.7,698744784,66.3,2019
42,Pirates of the Caribbean: On Stranger Tides,1046721266,241071802,23.0,805649464,77.0,2011
43,Despicable Me 3,1034800131,264624300,25.6,770175831,74.4,2017
44,Finding Dory,1029266989,486295561,47.2,542971428,52.8,2016
45,Star Wars: Episode I - The Phantom Menace,1027082707,474544677,46.2,552538030,53.8,1999
46,Zootopia,1025521689,341268248,33.3,684253441,66.7,2016
47,Alice in Wonderland,1025468216,334191110,32.6,691277106,67.4,2010
48,Harry Potter and the Sorcerer's Stone,1023842938,318886962,31.2,704955976,68.8,2001
49,The Hobbit: An Unexpected Journey,1017030651,303030651,29.8,714000000,70.2,2012
50,The Dark Knight,1006234167,534987076,53.2,471247091,46.8,2008
51,Jurassic World: Dominion,1001978080,376851080,37.6,625127000,62.4,2022
52,Jumanji: Welcome to the Jungle,995339117,404540171,40.6,590798946,59.4,2017
53,Harry Potter and the Deathly Hallows: Part 1,977070383,296374621,30.3,680695762,69.7,2010
54,Despicable Me 2,970766005,368065385,37.9,602700620,62.1,2013
55,The Lion King,968511805,422783777,43.6,545728028,56.4,1994
56,The Jungle Book,967724775,364001123,37.6,603723652,62.4,2016
57,The Hobbit: The Battle of the Five Armies,962201338,255138261,26.5,707063077,73.5,2014
58,Pirates of the Caribbean: At World's End,961691209,309420425,32.2,652270784,67.8,2007
59,The Hobbit: The Desolation of Smaug,959027992,258387334,26.9,700640658,73.1,2013
60,Doctor Strange in the Multiverse of Madness,955775804,411331607,43.0,544444197,57.0,2022
61,The Lord of the Rings: The Two Towers,947944270,342952511,36.2,604991759,63.8,2002
62,Harry Potter and the Order of the Phoenix,942278045,292382727,31.0,649895318,69.0,2007
63,Finding Nemo,941637960,380843261,40.4,560794699,59.6,2003
64,Minions: The Rise of Gru,939628210,369695210,39.3,569933000,60.7,2022
65,Harry Potter and the Half-Blood Prince,934504700,302334374,32.4,632170326,67.6,2009
66,Shrek 2,928760770,441226247,47.5,487534523,52.5,2004
67,Harry Potter and the Chamber of Secrets,925054421,262641637,28.4,662412784,71.6,2002
68,Bohemian Rhapsody,910809311,216668042,23.8,694141269,76.2,2018
69,The Battle at Lake Changjin,902548476,342411,0.1,902206065,100.0,2021
70,The Lord of the Rings: The Fellowship of the Ring,898204420,316115420,35.2,582089000,64.8,2001
71,Harry Potter and the Goblet of Fire,896815106,290469928,32.4,606345178,67.6,2005
72,Spider-Man 3,894983373,336530303,37.6,558453070,62.4,2007
73,The Secret Life of Pets,894328469,368384330,41.2,525944139,58.8,2016
74,Ice Age: Dawn of the Dinosaurs,886686817,196573705,22.2,690113112,77.8,2009
75,Spectre,880705312,200074609,22.7,680630703,77.3,2015
76,Spider-Man: Homecoming,880166924,334201140,38.0,545965784,62.0,2017
77,Ice Age: Continental Drift,877244782,161321843,18.4,715922939,81.6,2012
78,Batman v Superman: Dawn of Justice,873637528,330360194,37.8,543277334,62.2,2016
79,Wolf Warrior 2,870325439,2721100,0.3,867604339,99.7,2017
80,Star Wars: Episode III - Revenge of the Sith,868390560,380270577,43.8,488119983,56.2,2005
81,The Hunger Games: Catching Fire,865011746,424668047,49.1,440343699,50.9,2013
82,Guardians of the Galaxy Vol. 2,863756051,389813101,45.1,473942950,54.9,2017
83,Inside Out,858848019,356921711,41.6,501926308,58.4,2015
84,Venom,856085151,213515506,24.9,642569645,75.1,2018
85,Thor: Ragnarok,855301806,315058289,36.8,540243517,63.2,2017
86,The Twilight Saga: Breaking Dawn - Part 2,848853382,292324737,34.4,556528645,65.6,2012
87,Black Panther: Wakanda Forever,842121221,453209755,53.8,388911466,46.2,2022
88,Inception,836848102,292587330,35.0,544260772,65.0,2010
89,Transformers: Revenge of the Fallen,836303693,402111870,48.1,434191823,51.9,2009
90,Spider-Man,825025036,407022860,49.3,418002176,50.7,2002
91,Wonder Woman,822854286,412845172,50.2,410009114,49.8,2017
92,"Hi, Mom",822009764,0,0.0,822009764,100.0,2021
93,Independence Day,817400891,306169268,37.5,511231623,62.5,1996
94,Coco,814337054,210460015,25.8,603877039,74.2,2017
95,Fantastic Beasts and Where to Find Them,814044001,234037575,28.8,580006426,71.2,2016
96,Shrek the Third,813367380,322719944,39.7,490647436,60.3,2007
97,Jumanji: The Next Level,801693929,320314960,40.0,481378969,60.0,2019
98,Harry Potter and the Prisoner of Azkaban,797660766,250105651,31.4,547555115,68.6,2004
99,Pirates of the Caribbean: Dead Men Tell No Tales,795922298,172558876,21.7,623363422,78.3,2017
100,E.T. the Extra-Terrestrial,792910554,437141279,55.1,355769275,44.9,1982
101,Mission: Impossible - Fallout,791657398,220159104,27.8,571498294,72.2,2018
102,2012,791217826,166112167,21.0,625105659,79.0,2009
103,Indiana Jones and the Kingdom of the Crystal Skull,790653942,317101119,40.1,473552823,59.9,2008
104,Spider-Man 2,788976453,373585825,47.4,415390628,52.6,2004
105,Fast & Furious 6,788680968,238679850,30.3,550001118,69.7,2013
106,Deadpool 2,785896609,324591735,41.3,461304874,58.7,2018
107,Deadpool,782836791,363070709,46.4,419766082,53.6,2016
108,Star Wars: Episode IV - A New Hope,775398007,460998507,59.4,314399500,40.6,1977
109,No Time to Die,774153007,160891007,20.8,613262000,79.2,2021
110,Interstellar,773867216,188020017,24.3,585847199,75.7,2014
111,Guardians of the Galaxy,773350147,333718600,43.2,439631547,56.8,2014
112,The Batman,770945583,369345583,47.9,401600000,52.1,2022
113,Thor: Love and Thunder,760928081,343256830,45.1,417671251,54.9,2022
114,Fast & Furious Presents: Hobbs & Shaw,760732926,173956935,22.9,586775991,77.1,2019
115,The Da Vinci Code,760006945,217536138,28.6,542470807,71.4,2006
116,Maleficent,759853685,241410378,31.8,518443307,68.2,2014
117,The Amazing Spider-Man,757930663,262030663,34.6,495900000,65.4,2012
118,The Hunger Games: Mockingjay - Part 1,755356711,337135885,44.6,418220826,55.4,2014
119,Shrek Forever After,752600867,238736787,31.7,513864080,68.3,2010
120,Gravity,748049949,274092705,36.6,473957244,63.4,2013
121,Madagascar 3: Europe's Most Wanted,746921274,216391482,29.0,530529792,71.0,2012
122,Suicide Squad,746846894,325100054,43.5,421746840,56.5,2016
123,X-Men: Days of Future Past,746045700,233921534,31.4,512124166,68.6,2014
124,"The Chronicles of Narnia: The Lion, the Witch and the Wardrobe",745013115,291710957,39.2,453302158,60.8,2005
125,Monsters University,743559645,268492764,36.1,475066881,63.9,2013
126,The Matrix Reloaded,741847937,281576461,38.0,460271476,62.0,2003
127,Up,735099102,293004164,39.9,442094938,60.1,2009
128,Ne Zha,726264074,3695533,0.5,722568541,99.5,2019
129,F9: The Fast Saga,726229501,173005945,23.8,553223556,76.2,2021
130,Captain America: The Winter Soldier,714421503,259766572,36.4,454654931,63.6,2014
131,The Twilight Saga: Breaking Dawn - Part 1,712205856,281287133,39.5,430918723,60.5,2011
132,The Twilight Saga: New Moon,711025481,297816253,41.9,413209228,58.1,2009
133,Dawn of the Planet of the Apes,710644566,208545589,29.4,502098977,70.6,2014
134,Transformers,709709780,319246193,45.0,390463587,55.0,2007
135,The Amazing Spider-Man 2,708982323,202853933,28.6,506128390,71.4,2014
136,It,701842551,328874981,46.9,372967570,53.1,2017
137,The Wandering Earth,699992512,5971413,0.8,694021099,99.2,2019
138,The Twilight Saga: Eclipse,698509825,300531751,43.0,397978074,57.0,2010
139,Mission: Impossible - Ghost Protocol,694713380,209397903,30.1,485315477,69.9,2011
140,Mamma Mia!,694476782,144169664,20.8,550307118,79.2,2008
141,The Hunger Games,694394724,408010692,58.8,286384032,41.2,2012
142,Detective Chinatown 3,686257563,0,0.0,686257563,100.0,2021
143,Mission: Impossible - Rogue Nation,682716636,195042377,28.6,487674259,71.4,2015
144,Forrest Gump,678226465,330455270,48.7,347771195,51.3,1994
145,Doctor Strange,677796076,232641920,34.3,445154156,65.7,2016
146,The Sixth Sense,672806432,293506292,43.6,379300140,56.4,1999
147,Man of Steel,668045518,291045518,43.6,377000000,56.4,2013
148,Ice Age: The Meltdown,667094506,195330621,29.3,471763885,70.7,2006
149,Kung Fu Panda 2,665692281,165249063,24.8,500443218,75.2,2011
150,Moana,665069139,248757044,37.4,416312095,62.6,2016
151,Justice League,657926987,229024295,34.8,428902692,65.2,2017
152,Big Hero 6,657869686,222527828,33.8,435341858,66.2,2014
153,Fantastic Beasts: The Crimes of Grindelwald,654855901,159555901,24.4,495300000,75.6,2018
154,Pirates of the Caribbean: The Curse of the Black Pearl,654264015,305413918,46.7,348850097,53.3,2003
155,Men in Black 3,654213485,179020854,27.4,475192631,72.6,2012
156,Star Wars: Episode II - Attack of the Clones,653779970,310676740,47.5,343103230,52.5,2002
157,The Hunger Games: Mockingjay - Part 2,653428261,281723902,43.1,371704359,56.9,2015
158,Thor: The Dark World,644783140,206362140,32.0,438421000,68.0,2013
159,Sing,634338384,270578425,42.7,363759959,57.3,2016
160,Kung Fu Panda,632083197,215771591,34.1,416311606,65.9,2008
161,The Incredibles,631607053,261441092,41.4,370165961,58.6,2004
162,The Martian,630620818,228433663,36.2,402187155,63.8,2015
163,Hancock,629443428,227946274,36.2,401497154,63.8,2008
164,Water Gate Bridge,626571697,117294,0.1,626454403,100.0,2022
165,Fast Five,626137675,209837675,33.5,416300000,66.5,2011
166,Iron Man 2,623933331,312433331,50.1,311500000,49.9,2010
167,Ratatouille,623726085,206445654,33.1,417280431,66.9,2007
168,Ant-Man and the Wasp,622674139,216648740,34.8,406025399,65.2,2018
169,How to Train Your Dragon 2,621537519,177002924,28.5,444534595,71.5,2014
170,Logan,619179950,226277068,36.5,392902882,63.5,2017
171,The Lost World: Jurassic Park,618638999,229086679,37.0,389552320,63.0,1997
172,Casino Royale,616505162,167445960,27.2,449059202,72.8,2006
173,The Passion of the Christ,612054506,370782930,60.6,241271576,39.4,2004
174,Life of Pi,609016565,124987023,20.5,484029542,79.5,2012
175,Transformers: The Last Knight,605425157,130168683,21.5,475256474,78.5,2017
176,Madagascar: Escape 2 Africa,603900354,180010950,29.8,423889404,70.2,2008
177,War of the Worlds,603873119,234280354,38.8,369592765,61.2,2005
178,Tangled,592462816,200821936,33.9,391640880,66.1,2010
179,Ready Player One,592241728,137715350,23.2,454526378,76.8,2018
180,Quantum of Solace,589580482,168368427,28.6,421212055,71.4,2008
181,Men in Black,589390539,250690539,42.5,338700000,57.5,1997
182,The Croods,587235983,187168425,31.9,400067558,68.1,2013
183,The Hangover Part II,586764305,254464305,43.4,332300000,56.6,2011
184,Iron Man,585796247,319034126,54.5,266762121,45.5,2008
185,I Am Legend,585410052,256393010,43.8,329017042,56.2,2007
186,"Monsters, Inc.",579707738,290642256,50.1,289065482,49.9,2001
187,Operation Red Sea,579330426,1543547,0.3,577786879,99.7,2018
188,Night at the Museum,574481229,250863268,43.7,323617961,56.3,2006
189,Fifty Shades of Grey,569651467,166167230,29.2,403484237,70.8,2015
190,Kong: Skull Island,566652812,168052812,29.7,398600000,70.3,2017
191,The Smurfs,563749323,142614158,25.3,421135165,74.7,2011
192,Cars 2,559852396,191452396,34.2,368400000,65.8,2011
193,King Kong,556906378,218080025,39.2,338826353,60.8,2005
194,Puss in Boots,554987477,149260504,26.9,405726973,73.1,2011
195,The Mermaid,553810228,3232685,0.6,550577543,99.4,2016
196,Armageddon,553709788,201578182,36.4,352131606,63.6,1998
197,The Day After Tomorrow,552639571,186740799,33.8,365898772,66.2,2004
198,Ted,549368315,218815487,39.8,330552828,60.2,2012
199,American Sniper,547459020,350159020,64.0,197300000,36.0,2014
200,Mission: Impossible II,546388108,215409889,39.4,330978219,60.6,2000
201,Detective Chinatown 2,544185156,1983984,0.4,542201172,99.6,2018
202,X-Men: Apocalypse,543934105,155442489,28.6,388491616,71.4,2016
203,Sherlock Holmes: A Game of Shadows,543848418,186848418,34.4,357000000,65.6,2011
204,Despicable Me,543157985,251557985,46.3,291600000,53.7,2010
205,Cinderella,542358331,201151353,37.1,341206978,62.9,2015
206,Madagascar,542063846,193595521,35.7,348468325,64.3,2005
207,World War Z,540455876,202807711,37.5,337648165,62.5,2013
208,Brave,538983207,237283207,44.0,301700000,56.0,2012
209,Star Wars: Episode V - The Empire Strikes Back,538375067,292753960,54.4,245621107,45.6,1980
210,The Simpsons Movie,536414293,183135014,34.1,353279279,65.9,2007
211,The Revenant,532950503,183637894,34.5,349312609,65.5,2015
212,The Meg,530517320,145522784,27.4,384994536,72.6,2018
213,Ralph Breaks the Internet,529323962,201091711,38.0,328232251,62.0,2018
214,Hotel Transylvania 3: Summer Vacation,528583774,167510016,31.7,361073758,68.3,2018
215,The Boss Baby,527965936,175003033,33.2,352962903,66.8,2017
216,Dunkirk,527016307,189740665,36.0,337275642,64.0,2017
217,The Grinch,526760632,271384731,51.5,255375901,48.5,2018
218,Godzilla,524976069,200676069,38.2,324300000,61.8,2014
219,How to Train Your Dragon: The Hidden World,524580592,160945505,30.7,363635087,69.3,2019
220,Sherlock Holmes,524028679,209028679,39.9,315000000,60.1,2009
221,Meet the Fockers,522657936,279261160,53.4,243396776,46.6,2004
222,WALL·E,521311890,223808164,42.9,297503726,57.1,2008
223,Kung Fu Panda 3,521170825,143528619,27.5,377642206,72.5,2016
224,Terminator 2: Judgment Day,520881154,205881154,39.5,315000000,60.5,1991
225,Ant-Man,519311965,180202163,34.7,339109802,65.3,2015
226,Venom: Let There Be Carnage,506863592,213550366,42.1,293313226,57.9,2021
227,Ghost,505703557,217631306,43.0,288072251,57.0,1990
228,Aladdin,504050219,217350219,43.1,286700000,56.9,1992
229,Gladiator,503162313,187705427,37.3,315456886,62.7,2000
230,Rio 2,498781117,131538435,26.4,367242682,73.6,2014
231,Troy,497409852,133378256,26.8,364031596,73.2,2004
232,Toy Story 2,497375381,245852179,49.4,251523202,50.6,1999
233,How to Train Your Dragon,494879471,217581231,44.0,277298240,56.0,2010
234,Twister,494580615,241830615,48.9,252750000,51.1,1996
235,Oz the Great and Powerful,493311825,234911825,47.6,258400000,52.4,2013
236,Clash of the Titans,493214993,163214888,33.1,330000105,66.9,2010
237,Maleficent: Mistress of Evil,491730089,113929605,23.2,377800484,76.8,2019
238,War for the Planet of the Apes,490719763,146880162,29.9,343839601,70.1,2017
239,Shrek,488441368,268163011,54.9,220278357,45.1,2001
240,Mr. & Mrs. Smith,487287646,186336279,38.2,300951367,61.8,2005
241,Angels & Demons,485930816,133375846,27.4,352554970,72.6,2009
242,Teenage Mutant Ninja Turtles,485004754,191204754,39.4,293800000,60.6,2014
243,Bruce Almighty,484592874,242829261,50.1,241763613,49.9,2003
244,The King's Speech,484068861,138797449,28.7,345271412,71.3,2010
245,Rio,483866772,143619809,29.7,340246963,70.3,2011
246,Saving Private Ryan,482349603,217049603,45.0,265300000,55.0,1998
247,Rise of the Planet of the Apes,481800873,176760185,36.7,305040688,63.3,2011
248,Home Alone,476684675,285761243,60.0,190923432,40.0,1990
249,Jaws,476512065,265859065,55.8,210653000,44.2,1975
250,Hotel Transylvania 2,475186706,169700110,35.7,305486596,64.3,2015
251,Star Wars: Episode VI - Return of the Jedi,475106177,309306177,65.1,165800000,34.9,1983
252,Charlie and the Chocolate Factory,474968763,206459076,43.5,268509687,56.5,2005
253,Indiana Jones and the Last Crusade,474171806,197171806,41.6,277000000,58.4,1989
254,San Andreas,474009154,155190832,32.7,318818322,67.3,2015
255,It Chapter Two,473122525,211622525,44.7,261500000,55.3,2019
256,La La Land,472000520,151101803,32.0,320898717,68.0,2016
257,Wreck-It Ralph,471222889,189422889,40.2,281800000,59.8,2012
258,Godzilla vs. Kong,470116094,100916094,21.5,369200000,78.5,2021
259,The Hangover,469328079,277339746,59.1,191988333,40.9,2009
260,Lucy,469058574,126663600,27.0,342394974,73.0,2014
261,The Lego Movie,468266122,257966122,55.1,210300000,44.9,2014
262,Bumblebee,467989645,127195589,27.2,340794056,72.8,2018
263,Star Trek Into Darkness,467365246,228778661,49.0,238586585,51.0,2013
264,The Matrix,467222728,172076928,36.8,295145800,63.2,1999
265,Pretty Woman,463406268,178406268,38.5,285000000,61.5,1990
266,Cars,461991867,244082982,52.8,217908885,47.2,2006
267,The Eight Hundred,461421559,372755,0.1,461048804,99.9,2020
268,X-Men: The Last Stand,460435291,234362462,50.9,226072829,49.1,2006
269,Moon Man,460237662,0,0.0,460237662,100.0,2022
270,National Treasure: Book of Secrets,459242249,219964115,47.9,239278134,52.1,2007
271,Mission: Impossible,457696391,180981856,39.5,276714535,60.5,1996
272,300,456082343,210629101,46.2,245453242,53.8,2007
273,The Last Samurai,454627263,111127263,24.4,343500000,75.6,2003
274,Demon Slayer the Movie: Mugen Train,453210959,49505008,10.9,403705951,89.1,2020
275,Dying to Survive,451183391,6752,0.0,451176639,100.0,2018
276,Ocean's Eleven,450717150,183417150,40.7,267300000,59.3,2001
277,"My People, My Country",450064993,2356683,0.5,447708310,99.5,2019
278,Thor,449326618,181030624,40.3,268295994,59.7,2011
279,Pearl Harbor,449220945,198542554,44.2,250678391,55.8,2001
280,Tarzan,448191819,171091819,38.2,277100000,61.8,1999
281,Men in Black II,445135288,193735288,43.5,251400000,56.5,2002
282,The Bourne Ultimatum,444100035,227471070,51.2,216628965,48.8,2007
283,The Mummy Returns,443280904,202019785,45.6,241261119,54.4,2001
284,Alvin and the Chipmunks: The Squeakquel,443140005,219614612,49.6,223525393,50.4,2009
285,Les Misérables,442299309,148809770,33.6,293489539,66.4,2012
286,The Exorcist,441306145,233005644,52.8,208300501,47.2,1973
287,Mrs. Doubtfire,441286195,219195243,49.7,222090952,50.3,1993
288,Terminator Genisys,440603537,89760956,20.4,350842581,79.6,2015
289,Warcraft,439048914,47365290,10.8,391683624,89.2,2016
290,A Star Is Born,436233122,215333122,49.4,220900000,50.6,2018
291,The Greatest Showman,435732529,174340174,40.0,261392355,60.0,2017
292,Terminator 3: Rise of the Machines,433371112,150371112,34.7,283000000,65.3,2003
293,Pokémon: Detective Pikachu,433230304,144174568,33.3,289055736,66.7,2019
294,Shang-Chi and the Legend of the Ten Rings,432243292,224543292,52.0,207700000,48.0,2021
295,Die Another Day,431971116,160942139,37.3,271028977,62.7,2002
296,The Secret Life of Pets 2,431058415,158874395,36.9,272184020,63.1,2019
297,Cast Away,429632142,233632142,54.4,196000000,45.6,2000
298,Rampage,428028233,101028233,23.6,327000000,76.4,2018
299,The Matrix Revolutions,427344325,139313948,32.6,288030377,67.4,2003
300,The Intouchables,426588510,10198820,2.4,416389690,97.6,2011
301,Bad Boys for Life,426505244,206305244,48.4,220200000,51.6,2020
302,Django Unchained,426074373,162805434,38.2,263268939,61.8,2012
303,Beauty and the Beast,424967620,218967620,51.5,206000000,48.5,1991
304,Dances with Wolves,424208848,184208848,43.4,240000000,56.6,1990
305,"My People, My Homeland",422390820,0,0.0,422390820,100.0,2020
306,The Chronicles of Narnia: Prince Caspian,419665568,141621490,33.8,278044078,66.2,2008
307,Sex and the City,418765519,152647258,36.4,266118261,63.6,2008
308,The Captain,417282021,706572,0.2,416575449,99.8,2019
309,The Mummy,415933406,155385488,37.4,260547918,62.6,1999
310,The Chronicles of Narnia: The Voyage of the Dawn Treader,415686217,104386950,25.1,311299267,74.9,2010
311,Jason Bourne,415484914,162434410,39.1,253050504,60.9,2016
312,Mad Max: Fury Road,415261382,154109060,37.1,261152322,62.9,2015
313,The Wolverine,414828246,132556852,32.0,282271394,68.0,2013
314,Kingsman: The Secret Service,414351546,128261724,31.0,286089822,69.0,2015
315,Night at the Museum: Battle of the Smithsonian,413106170,177243721,42.9,235862449,57.1,2009
316,Batman,411569241,251409241,61.1,160160000,38.9,1989
317,The Bodyguard,411046449,122046449,29.7,289000000,70.3,1992
318,Pacific Rim,411002906,101802906,24.8,309200000,75.2,2013
319,Kingsman: The Golden Circle,410902662,100234838,24.4,310667824,75.6,2017
320,The Mummy,409231607,80227895,19.6,329003712,80.4,2017
321,Ice Age: Collision Course,408754975,64063008,15.7,344691967,84.3,2016
322,Twilight,408430415,193962473,47.5,214467942,52.5,2008
323,Sing 2,408398852,162790990,39.9,245607862,60.1,2021
324,Signs,408247917,227966634,55.8,180281283,44.2,2002
325,X2: X-Men United,407711549,214949694,52.7,192761855,47.3,2003
326,Fantastic Beasts: The Secrets of Dumbledore,406950844,95850844,23.6,311100000,76.4,2022
327,The Wolf of Wall Street,406878233,116900694,28.7,289977539,71.3,2013
328,Alita: Battle Angel,404980543,85838210,21.2,319142333,78.8,2019
329,The Mummy: Tomb of the Dragon Emperor,403449830,102491776,25.4,300958054,74.6,2008
330,Prometheus,403354469,126477084,31.4,276877385,68.6,2012
331,Sonic the Hedgehog 2,402656846,190872904,47.4,211783942,52.6,2022
332,Gone with the Wind,402382193,200882193,49.9,201500000,50.1,1939
333,Mamma Mia! Here We Go Again,402264843,120634935,30.0,281629908,70.0,2018
334,Eternals,402064899,164870234,41.0,237194665,59.0,2021
335,Dune,402027830,108327830,27.0,293700000,73.0,2021
336,Uncharted,401748820,148648820,37.0,253100000,63.0,2022
337,Tron: Legacy,400063852,172062763,43.0,228001089,57.0,2010
338,Mission: Impossible III,398479497,134029801,33.6,264449696,66.4,2006
339,Snow White and the Huntsman,396592829,155332381,39.2,241260448,60.8,2012
340,Grease,396271103,190071103,48.0,206200000,52.0,1978
341,Toy Story,394436586,223225679,56.6,171210907,43.4,1995
342,Black Adam,392952111,168152111,42.8,224800000,57.2,2022
343,Solo: A Star Wars Story,392924807,213767512,54.4,179157295,45.6,2018
344,Superman Returns,391081192,200081192,51.2,191000000,48.8,2006
345,Robin Hood: Prince of Thieves,390493908,165493908,42.4,225000000,57.6,1991
346,Indiana Jones and the Raiders of the Lost Ark,389925971,248159971,63.6,141766000,36.4,1981
347,Independence Day: Resurgence,389681935,103144286,26.5,286537649,73.5,2016
348,Live Free or Die Hard,388156011,134529403,34.7,253626608,65.3,2007
349,Monster Hunt,387053506,32766,0.1,387020740,100.0,2015
350,Godzilla: King of the Monsters,386600138,110500138,28.6,276100000,71.4,2019
351,Home,386041607,177397510,46.0,208644097,54.0,2015
352,Star Trek,385680446,257730019,66.8,127950427,33.2,2009
353,1917,384479940,159227644,41.4,225252296,58.6,2019
354,Happy Feet,384336108,198000317,51.5,186335791,48.5,2006
355,Spider-Man: Into the Spider-Verse,384256930,190241310,49.5,194015620,50.5,2018
356,Cars 3,383930656,152901115,39.8,231029541,60.2,2017
357,Back to the Future,383336762,212836762,55.5,170500000,44.5,1985
358,Ice Age,383257136,176387405,46.0,206869731,54.0,2002
359,Your Name.,382238181,5017246,1.3,377220935,98.7,2016
360,Fifty Shades Darker,381545846,114581250,30.0,266964596,70.0,2017
361,Monsters vs. Aliens,381509870,198351526,52.0,183158344,48.0,2009
362,Black Widow,379751655,183651655,48.4,196100000,51.6,2021
363,Godzilla,379014294,136314294,36.0,242700000,64.0,1998
364,True Lies,378882411,146282411,38.6,232600000,61.4,1994
365,Slumdog Millionaire,378410542,141319928,37.4,237090614,62.6,2008
366,Once Upon a Time in Hollywood,377617598,142502728,37.7,235114870,62.3,2019
367,Taken 2,376152455,139854287,37.2,236298168,62.8,2012
368,G.I. Joe: Retaliation,375740705,122523060,32.6,253217645,67.4,2013
369,Shark Tale,374583879,160861908,42.9,213721971,57.1,2004
370,What Women Want,374111707,182811707,48.9,191300000,51.1,2000
371,The Adventures of Tintin,373993951,77591831,20.8,296402120,79.2,2011
372,Batman Begins,373672993,206863479,55.4,166809514,44.6,2005
373,Penguins of Madagascar,373515621,83850911,22.4,289664710,77.6,2014
374,X-Men Origins: Wolverine,373062864,179883157,48.2,193179707,51.8,2009
375,The Golden Compass,372234864,70107728,18.8,302127136,81.2,2007
376,Fifty Shades Freed,371985018,100407760,27.0,271577258,73.0,2018
377,Hitch,371594210,179495555,48.3,192098655,51.7,2005
378,Terminator Salvation,371353001,125322469,33.8,246030532,66.2,2009
379,Captain America: The First Avenger,370569774,176654505,47.7,193915269,52.3,2011
380,Edge of Tomorrow,370541256,100206256,27.0,270335000,73.0,2014
381,There's Something About Mary,369884651,176484651,47.7,193400000,52.3,1998
382,Gone Girl,369330363,167767189,45.4,201563174,54.6,2014
383,The Fugitive,368875760,183875760,49.8,185000000,50.2,1993
384,Jurassic Park III,368780809,181171875,49.1,187608934,50.9,2001
385,My Big Fat Greek Wedding,368744044,241438208,65.5,127305836,34.5,2002
386,Hello Mr. Billionaire,366961907,0,0.0,366961907,100.0,2018
387,Die Hard with a Vengeance,366101666,100012499,27.3,266089167,72.7,1995
388,Shazam!,366080049,140480049,38.4,225600000,61.6,2019
389,The Nun,365582797,117481222,32.1,248101575,67.9,2018
390,Alvin and the Chipmunks,365352546,217326974,59.5,148025572,40.5,2007
391,Tenet,365304105,58504105,16.0,306800000,84.0,2020
392,Notting Hill,363889678,116089678,31.9,247800000,68.1,1999
393,A Bug's Life,363258859,162798565,44.8,200460294,55.2,1998
394,Night at the Museum: Secret of the Tomb,363204635,113746621,31.3,249458014,68.7,2014
395,Ocean's Twelve,362744280,125544280,34.6,237200000,65.4,2004
396,Planet of the Apes,362211740,180011740,49.7,182200000,50.3,2001
397,The Hangover Part III,362000072,112200072,31.0,249800000,69.0,2013
398,The World Is Not Enough,361832400,126943684,35.1,234888716,64.9,1999
399,Monster Hunt 2,361682618,706153,0.2,360976465,99.8,2018
400,Fast & Furious,360366870,155064265,43.0,205302605,57.0,2009
401,Noah,359200044,101200044,28.2,258000000,71.8,2014
402,The Karate Kid,359126022,176591618,49.2,182534404,50.8,2010
403,Home Alone 2: Lost in New York,358994850,173585516,48.4,185409334,51.6,1992
404,Hotel Transylvania,358375603,148313048,41.4,210062555,58.6,2012
405,Minority Report,358372926,132072926,36.8,226300000,63.2,2002
406,Top Gun,357288178,180258178,50.4,177030000,49.6,1986
407,The Legend of Tarzan,356700357,126643061,35.5,230057296,64.5,2016
408,American Beauty,356296601,130096601,36.5,226200000,63.5,1999
409,Spirited Away,355822319,13750644,3.9,342071675,96.1,2001
410,Apollo 13,355237933,173837933,48.9,181400000,51.1,1995
411,Rain Man,354825435,172825435,48.7,182000000,51.3,1988
412,The Great Gatsby,353659851,144857996,41.0,208801855,59.0,2013
413,Dumbo,353284621,114766307,32.5,238518314,67.5,2019
414,"I, Robot",353133898,144801023,41.0,208332875,59.0,2004
415,Basic Instinct,352927224,117727224,33.4,235200000,66.6,1992
416,Murder on the Orient Express,352794081,102826543,29.2,249967538,70.8,2017
417,X-Men: First Class,352616690,146408305,41.5,206208385,58.5,2011
418,The Angry Birds Movie,352333929,107509366,30.5,244824563,69.5,2016
419,GoldenEye,352194034,106429941,30.2,245764093,69.8,1995
420,Catch Me If You Can,352114312,164615351,46.8,187498961,53.2,2002
421,Now You See Me,351723989,117723989,33.5,234000000,66.5,2013
422,Hannibal,351692268,165092268,46.9,186600000,53.1,2001
423,The Mask,351583407,119938730,34.1,231644677,65.9,1994
424,Peter Rabbit,351496066,115253424,32.8,236242642,67.2,2018
425,Speed,350448145,121248145,34.6,229200000,65.4,1994
426,Dinosaur,349822765,137748063,39.4,212074702,60.6,2000
427,Mary Poppins Returns,349546142,171958438,49.2,177587704,50.8,2018
428,Deep Impact,349464664,140464664,40.2,209000000,59.8,1998
429,The Lorax,349183316,214373500,61.4,134809816,38.6,2012
430,The Maze Runner,348319861,102427862,29.4,245891999,70.6,2014
431,The Smurfs 2,347545360,71017784,20.4,276527576,79.6,2013
432,National Treasure,347512318,173008894,49.8,174503424,50.2,2004
433,Rush Hour 2,347325802,226164286,65.1,121161516,34.9,2001
434,Trolls,347182886,154025064,44.4,193157822,55.6,2016
435,xXx: Return of Xander Cage,346118277,44898413,13.0,301219864,87.0,2017
436,Pocahontas,346079773,141579773,40.9,204500000,59.1,1995
437,How the Grinch Stole Christmas,345823032,260715005,75.4,85108027,24.6,2000
438,Star Trek Beyond,343471816,158848340,46.2,184623476,53.8,2016
439,Alvin and the Chipmunks: Chipwrecked,342695435,133110742,38.8,209584693,61.2,2011
440,Wanted,342463063,134508551,39.3,207954512,60.7,2008
441,The Flintstones,341631208,130531208,38.2,211100000,61.8,1994
442,Puss in Boots: The Last Wish,341031443,142772690,41.9,198258753,58.1,2022
443,A Quiet Place,340952971,188024361,55.2,152928610,44.8,2018
444,Enchanted,340487836,127807262,37.5,212680574,62.5,2007
445,Over the Hedge,339795890,155019340,45.6,184776550,54.4,2006
446,300: Rise of an Empire,337580051,106580051,31.6,231000000,68.4,2014
447,Batman Forever,336567158,184069126,54.7,152498032,45.3,1995
448,Prince of Persia: The Sands of Time,336365676,90759676,27.0,245606000,73.0,2009
449,The Curious Case of Benjamin Button,335802786,127509326,38.0,208293460,62.0,2008
450,Journey 2: The Mysterious Island,335287748,103887748,31.0,231400000,69.0,2012
451,The Rock,335062621,134069511,40.0,200993110,60.0,1996
452,The Great Wall,334933831,45540830,13.6,289393001,86.4,2016
453,Now You See Me 2,334897606,65075540,19.4,269822066,80.6,2016
454,Never Say Die,334530869,0,0.0,334530869,100.0,2017
455,Fantastic Four,333535934,154696080,46.4,178839854,53.6,2005
456,Indiana Jones and the Temple of Doom,333107271,179870271,54.0,153237000,46.0,1984
457,Tomorrow Never Dies,333011068,125304276,37.6,207706792,62.4,1997
458,Back to the Future Part II,332500002,119000002,35.8,213500000,64.2,1989
459,The Good Dinosaur,332207671,123087120,37.0,209120551,63.0,2015
460,Free Guy,331526598,121626598,36.7,209900000,63.3,2021
461,22 Jump Street,331333876,191719337,57.9,139614539,42.1,2014
462,Meet the Parents,330444045,166244045,50.3,164200000,49.7,2000
463,Who Framed Roger Rabbit,329803958,156452370,47.4,173351588,52.6,1988
464,Black Swan,329398046,106954678,32.5,222443368,67.5,2010
465,The Perfect Storm,328718434,182618434,55.6,146100000,44.4,2000
466,John Wick: Chapter 3 - Parabellum,328349387,171015687,52.1,157333700,47.9,2019
467,Crocodile Dundee,328203506,174803506,53.3,153400000,46.7,1986
468,Crazy Alien,327598891,0,0.0,327598891,100.0,2019
469,Se7en,327333559,100125643,30.6,227207916,69.4,1995
470,The Devil Wears Prada,326706115,124740460,38.2,201965655,61.8,2006
471,Taken 3,326479141,89256424,27.3,237222717,72.7,2015
472,The Hunchback of Notre Dame,325338851,100138851,30.8,225200000,69.2,1996
473,A Christmas Carol,325286646,137855863,42.4,187430783,57.6,2009
474,The SpongeBob Movie: Sponge Out of Water,325186032,162994032,50.1,162192000,49.9,2015
475,Schindler's List,322161245,96898818,30.1,225262427,69.9,1993
476,Megamind,321885765,148415853,46.1,173469912,53.9,2010
477,The Conjuring 2,321834351,102516140,31.8,219318211,68.2,2016
478,Green Book,321752656,85080171,26.4,236672485,73.6,2018
479,Lethal Weapon 3,321731527,144731527,45.0,177000000,55.0,1992
480,Robin Hood,321669741,105269730,32.7,216400011,67.3,2010
481,Inglourious Basterds,321457747,120540719,37.5,200917028,62.5,2009
482,101 Dalmatians,320689294,136189294,42.5,184500000,57.5,1996
483,The Conjuring,320406242,137446368,42.9,182959874,57.1,2013
484,Fatal Attraction,320145693,156645693,48.9,163500000,51.1,1987
485,Sonic the Hedgehog,319715683,148974665,46.6,170741018,53.4,2020
486,The Last Airbender,319713881,131772187,41.2,187941694,58.8,2010
487,The Proposal,317375031,163958031,51.7,153417000,48.3,2009
488,The Polar Express,316897787,189528738,59.8,127369049,40.2,2004
489,A Beautiful Mind,316791257,170742341,53.9,146048916,46.1,2001
490,Beverly Hills Cop,316360478,234760478,74.2,81600000,25.8,1984
491,Air Force One,315156409,172956409,54.9,142200000,45.1,1997
492,Wonder,315025930,132422809,42.0,182603121,58.0,2017
493,The Expendables 2,314975955,85028192,27.0,229947763,73.0,2012
494,Chicken Little,314432837,135386665,43.1,179046172,56.9,2005
495,As Good as It Gets,314178011,148478011,47.3,165700000,52.7,1997
496,Knives Out,312897920,165363234,52.8,147534686,47.2,2019
497,Maze Runner: The Scorch Trials,312296056,81697192,26.2,230598864,73.8,2015
498,Resident Evil: The Final Chapter,312242626,26830068,8.6,285412558,91.4,2016
499,The Lego Batman Movie,312136671,175936671,56.4,136200000,43.6,2017
500,Austin Powers: The Spy Who Shagged Me,312016928,206040086,66.0,105976842,34.0,1999
501,Ocean's Thirteen,311312624,117154724,37.6,194157900,62.4,2007
502,Little Fockers,310650585,148438600,47.8,162211985,52.2,2010
503,Bolt,309979994,114053579,36.8,195926415,63.2,2008
504,Ransom,309492681,136492681,44.1,173000000,55.9,1996
505,Runaway Bride,309460292,152257509,49.2,157202783,50.8,1999
506,The Blind Side,309231694,255982860,82.8,53248834,17.2,2009
507,The Ex-File 3: The Return of The Exes,307592427,838959,0.3,306753468,99.7,2017
508,The Fault in Our Stars,307166834,124872350,40.6,182294484,59.4,2014
509,The Pursuit of Happyness,307127625,163566459,53.3,143561166,46.7,2006
510,Rise of the Guardians,306941670,103412758,33.7,203528912,66.3,2012
511,Close Encounters of the Third Kind,306889114,135189114,44.0,171700000,56.0,1977
512,Chicago,306776732,170687518,55.6,136089214,44.4,2002
513,Annabelle: Creation,306515884,102092201,33.3,204423683,66.7,2017
514,Bridesmaids,306442085,169106725,55.2,137335360,44.8,2011
515,Skyscraper,304868961,68420120,22.4,236448841,77.6,2018
516,A Good Day to Die Hard,304654182,67349198,22.1,237304984,77.9,2013
517,Mulan,304320254,120620254,39.6,183700000,60.4,1998
518,Dangal,303723636,12391761,4.1,291331875,95.9,2016
519,Passengers,303144152,100014699,33.0,203129453,67.0,2016
520,Battleship,303025485,65422625,21.6,237602860,78.4,2012
521,Liar Liar,302710615,181410615,59.9,121300000,40.1,1997
522,G.I. Joe: The Rise of Cobra,302469017,150201498,49.7,152267519,50.3,2009
523,Wrath of the Titans,301970083,83670083,27.7,218300000,72.3,2012
524,Fantastic Four: Rise of the Silver Surfer,301913131,131921738,43.7,169991393,56.3,2007
525,Hook,300854823,119654823,39.8,181200000,60.2,1991
526,Superman,300478449,134478449,44.8,166000000,55.2,1978
527,Rocky IV,300473716,127873716,42.6,172600000,57.4,1985
528,Rambo: First Blood Part II,300400432,150415432,50.1,149985000,49.9,1985
529,Resident Evil: Afterlife,300228084,60128566,20.0,240099518,80.0,2010
530,Van Helsing,300157638,120177084,40.0,179980554,60.0,2004
531,Stuart Little,300135367,140035367,46.7,160100000,53.3,1999
532,Beverly Hills Cop II,299965036,153665036,51.2,146300000,48.8,1987
533,Alice Through the Looking Glass,299820798,77041381,25.7,222779417,74.3,2016
534,My Best Friend's Wedding,299288605,127120029,42.5,172168576,57.5,1997
535,Real Steel,299268508,85468508,28.6,213800000,71.4,2011
536,Horton Hears a Who!,298572799,154529439,51.8,144043360,48.2,2008
537,Ocean's Eight,297795726,140295726,47.1,157500000,52.9,2018
538,A Quiet Place Part II,297372261,160072261,53.8,137300000,46.2,2021
539,The Divergent Series: Insurgent,297002527,130179072,43.8,166823455,56.2,2015
540,Look Who's Talking,296999813,140088813,47.2,156911000,52.8,1989
541,Austin Powers in Goldmember,296938801,213307889,71.8,83630912,28.2,2002
542,Ghostbusters,296578797,243578797,82.1,53000000,17.9,1984
543,Miss Peregrine's Home for Peculiar Children,296482446,87242834,29.4,209239612,70.6,2016
544,X-Men,296339528,157299718,53.1,139039810,46.9,2000
545,Ferdinand,296069199,84410380,28.5,211658819,71.5,2017
546,Shutter Island,294805697,128012934,43.4,166792763,56.6,2010
547,Doctor Dolittle,294456605,144156605,49.0,150300000,51.0,1998
548,Bee Movie,293514336,126631277,43.1,166883059,56.9,2007
549,Salt,293503354,118311368,40.3,175191986,59.7,2010
550,G-Force,292817898,119436770,40.8,173381128,59.2,2009
551,The Departed,291480452,132399394,45.4,159081058,54.6,2006
552,What Lies Beneath,291420351,155464351,53.4,135956000,46.6,2000
553,Pacific Rim: Uprising,290930148,59874525,20.6,231055623,79.4,2018
554,The Bourne Supremacy,290835269,176241941,60.6,114593328,39.4,2004
555,Sex and the City 2,290745055,95347692,32.8,195397363,67.2,2010
556,Shakespeare in Love,289317794,100317794,34.7,189000000,65.3,1998
557,Divergent,288885818,150947895,52.2,137937923,47.8,2014
558,Coming to America,288752301,128152301,44.4,160600000,55.6,1988
559,Wedding Crashers,288485135,209273411,72.5,79211724,27.5,2005
560,Maze Runner: The Death Cure,288175335,58032443,20.1,230142892,79.9,2018
561,Casper,287928194,100328194,34.8,187600000,65.2,1995
562,American Pie 2,287553595,145103595,50.5,142450000,49.5,2001
563,Elvis,287340048,151040048,52.6,136300000,47.4,2022
564,Pitch Perfect 2,287144079,184296230,64.2,102847849,35.8,2015
565,The Green Mile,286801374,136801374,47.7,150000000,52.3,1999
566,Oblivion,286168572,89107235,31.1,197061337,68.9,2013
567,Elysium,286140700,93050117,32.5,193090583,67.5,2013
568,Lethal Weapon 4,285444603,130444603,45.7,155000000,54.3,1998
569,John Carter,284139100,73078100,25.7,211061000,74.3,2012
570,Turbo,282570682,83028128,29.4,199542554,70.6,2013
571,Paddington,282377683,76271832,27.0,206105851,73.0,2014
572,Bridget Jones's Diary,281995610,71543427,25.4,210452183,74.6,2001
573,The Tourist,278780441,67631157,24.3,211149284,75.7,2010
574,Split,278454417,138291365,49.7,140163052,50.3,2017
575,Scary Movie,278019771,157019771,56.5,121000000,43.5,2000
576,xXx,277448382,142109382,51.2,135339000,48.8,2002
577,The Bourne Legacy,276144750,113203870,41.0,162940880,59.0,2012
578,Mr. Peabody & Sherman,275698039,111506430,40.4,164191609,59.6,2014
579,Scooby-Doo,275678613,153322074,55.6,122356539,44.4,2002
580,Lincoln,275293450,182207973,66.2,93085477,33.8,2012
581,Lara Croft: Tomb Raider,274703340,131168070,47.8,143535270,52.2,2001
582,Tomb Raider,274650803,58250803,21.2,216400000,78.8,2018
583,The Expendables,274470394,103068524,37.6,171401870,62.4,2010
584,Cloudy with a Chance of Meatballs 2,274325949,119793567,43.7,154532382,56.3,2013
585,The Nutty Professor,273961019,128814019,47.0,145147000,53.0,1996
586,Jerry Maguire,273552592,153952592,56.3,119600000,43.7,1996
587,Bad Boys II,273339556,138608444,50.7,134731112,49.3,2003
588,Lilo & Stitch,273144151,145794338,53.4,127349813,46.6,2002
589,The Silence of the Lambs,272742922,130742922,47.9,142000000,52.1,1991
590,Grown Ups,271457301,162001186,59.7,109456115,40.3,2010
591,Neighbors,270665134,150157400,55.5,120507734,44.5,2014
592,The Firm,270248367,158348367,58.6,111900000,41.4,1993
593,We're the Millers,269994119,150394119,55.7,119600000,44.3,2012
594,Gran Torino,269958228,148095302,54.9,121862926,45.1,2008
595,"10,000 BC",269784201,94784201,35.1,175000000,64.9,2008
596,American Gangster,269755430,130164645,48.2,139590785,51.8,2007
597,Epic,268426634,107518682,40.1,160907952,59.9,2013
598,Exodus: Gods and Kings,268175631,65014513,24.2,203161118,75.8,2014
599,Blade Runner 2049,267770708,92071675,34.4,175699033,65.6,2017
600,Bambi,267447150,102247150,38.2,165200000,61.8,1942
601,The Princess and the Frog,267045765,104400899,39.1,162644866,60.9,2009
602,Batman Returns,266915287,162924631,61.0,103990656,39.0,1992
603,Indecent Proposal,266614059,106614059,40.0,160000000,60.0,1993
604,Something's Gotta Give,265328738,124728738,47.0,140600000,53.0,2003
605,Bridget Jones: The Edge of Reason,265126918,40226215,15.2,224900703,84.8,2004
606,The Incredible Hulk,264770996,134806913,50.9,129964083,49.1,2008
607,Waterworld,264218220,88246220,33.4,175972000,66.6,1995
608,The Truman Show,264118201,125618201,47.6,138500000,52.4,1998
609,Charlie's Angels,264105545,125305545,47.4,138800000,52.6,2000
610,The Fifth Element,263920180,63820180,24.2,200100000,75.8,1997
611,Jumanji,262821940,100499940,38.2,162322000,61.8,1995
612,Parasite,262676096,53369749,20.3,209306347,79.7,2019
613,Borat,262552893,128505958,48.9,134046935,51.1,2006
614,Robots,262511490,128200012,48.8,134311478,51.2,2005
615,Knight and Day,261989769,76423035,29.2,185566734,70.8,2008
616,Total Recall,261317921,119412921,45.7,141905000,54.3,1990
617,This Is It,261183588,72091016,27.6,189092572,72.4,2009
618,Terminator: Dark Fate,261119292,62253077,23.8,198866215,76.2,2019
619,The Lone Ranger,260502115,89302115,34.3,171200000,65.7,2013
620,Super 8,260095986,127004179,48.8,133091807,51.2,2011
621,Halloween,259939835,159342015,61.3,100597820,38.7,2018
622,Mojin: The Lost Legend,259368448,1243810,0.5,258124638,99.5,2015
623,Charlie's Angels: Full Throttle,259175788,100830111,38.9,158345677,61.1,2003
624,Rush Hour 3,258097122,140125968,54.3,117971154,45.7,2007
625,The Full Monty,257938649,45950122,17.8,211988527,82.2,1997
626,Kung Fu Yoga,257753889,362657,0.1,257391232,99.9,2017
627,Annabelle,257589721,84284252,32.7,173305469,67.3,2014
628,Encanto,256786742,96093622,37.4,160693120,62.6,2021
629,The Village,256697520,114197520,44.5,142500000,55.5,2003
630,Lost in Hong Kong,256283912,1302281,0.5,254981631,99.5,2015
631,Erin Brockovich,256271286,125595205,49.0,130676081,51.0,2000
632,Us,256067149,175084580,68.4,80982569,31.6,2019
633,Pegasus,255863112,0,0.0,255863112,100.0,2019
634,Get Out,255745157,176196665,68.9,79548492,31.1,2016
635,Marley & Me,255743093,143153751,56.0,112589342,44.0,2008
636,Cliffhanger,255000211,84049211,33.0,170951000,67.0,1993
637,Baahubali 2: The Conclusion,254158390,20186659,7.9,233971731,92.1,2017
638,Babe,254134910,63658910,25.0,190476000,75.0,1995
639,Men in Black: International,253890701,80001807,31.5,173888894,68.5,2019
640,Wild Hogs,253625427,168273550,66.4,85351877,33.6,2007
641,High School Musical 3: Senior Year,252909177,90559416,35.8,162349761,64.2,2008
642,Hercules,252712101,99112101,39.2,153600000,60.8,1997
643,X-Men: Dark Phoenix,252442974,65845974,26.1,186597000,73.9,2019
644,True Grit,252276927,171243005,67.9,81033922,32.1,2010
645,Dolittle,251410631,77047065,30.6,174363566,69.4,2020
646,Bean,251212670,45319423,18.0,205893247,82.0,1997
647,American Hustle,251171807,150117807,59.8,101054000,40.2,2013
648,Enemy of the State,250849789,111549836,44.5,139299953,55.5,1998
649,You've Got Mail,250821495,115821495,46.2,135000000,53.8,1998
650,Eragon,250425512,75030163,30.0,175395349,70.0,2006
651,Brother Bear,250397798,85336277,34.1,165061521,65.9,2003
652,The Godfather,250341816,136381073,54.5,113960743,45.5,1972
653,The Mask of Zorro,250288523,94095523,37.6,156193000,62.4,1998
654,The Bad Guys,250162278,97233630,38.9,152928648,61.1,2022
655,The Ring,249348933,129128133,51.8,120220800,48.2,2002
656,The Blair Witch Project,248639099,140539099,56.5,108100000,43.5,1999
657,Unbreakable,248118121,95011339,38.3,153106782,61.7,2000
658,Love Actually,247933248,59696144,24.1,188237104,75.9,2003
659,Journey to the West: The Demons Strike Back,247585244,880346,0.4,246704898,99.6,2017
660,Dumb and Dumber,247290327,127190327,51.4,120100000,48.6,1994
661,Glass,246999039,111048468,45.0,135950571,55.0,2019
662,Grown Ups 2,246984278,133668525,54.1,113315753,45.9,2013
663,The Peanuts Movie,246233113,130178411,52.9,116054702,47.1,2015
664,Rango,245724603,123477607,50.2,122246996,49.8,2011
665,Four Weddings and a Funeral,245700832,52700832,21.4,193000000,78.6,1994
666,Face/Off,245676146,112276146,45.7,133400000,54.3,1997
667,Teenage Mutant Ninja Turtles: Out of the Shadows,245623848,82051601,33.4,163572247,66.6,2016
668,Dark Shadows,245527149,79727149,32.5,165800000,67.5,2012
669,Hulk,245285165,132177234,53.9,113107931,46.1,2003
670,The Bravest,245179562,290217,0.1,244889345,99.9,2019
671,Welcome to the Sticks,245144417,0,0.0,245144417,100.0,2008
672,Back to the Future Part III,245077583,88277583,36.0,156800000,64.0,1990
673,Pixels,244874809,78747585,32.2,166127224,67.8,2015
674,Hercules,244819862,72688614,29.7,172131248,70.3,2014
675,Rush Hour,244721064,141186864,57.7,103534200,42.3,1998
676,Journey to the Center of the Earth,244232688,101704370,41.6,142528318,58.4,2008
677,After Earth,243611982,60522097,24.8,183089885,75.2,2013
678,A Few Good Men,243240178,141340178,58.1,101900000,41.9,1992
679,Cloudy with a Chance of Meatballs,243006126,124870275,51.4,118135851,48.6,2009
680,8 Mile,242875078,116750901,48.1,126124177,51.9,2002
681,Daddy's Home,242786137,150357137,61.9,92429000,38.1,2015
682,RoboCop,242688965,58607007,24.2,184081958,75.8,2014
683,Eraser,242295562,101295562,41.8,141000000,58.2,1996
684,Alien: Covenant,240891763,74262031,30.8,166629732,69.2,2017
685,Sully,240797623,125070033,51.9,115727590,48.1,2016
686,Assassin's Creed,240697856,54647948,22.7,186049908,77.3,2016
687,Click,240685326,137355633,57.1,103329693,42.9,2006
688,Legend of Deification,240646355,214670,0.1,240431685,99.9,2020
689,Planes,240171783,90288712,37.6,149883071,62.4,2013
690,Resident Evil: Retribution,240159255,42345531,17.6,197813724,82.4,2012
691,Die Hard 2,240031274,117540947,49.0,122490327,51.0,1990
692,Crocodile Dundee II,239606210,109306210,45.6,130300000,54.4,1988
693,Bullet Train,239268602,103368602,43.2,135900000,56.8,2022
694,Crazy Rich Asians,238843729,174837452,73.2,64006277,26.8,2018
695,Batman & Robin,238235719,107353792,45.1,130881927,54.9,1997
696,Howl's Moving Castle,237536126,6789268,2.9,230746858,97.1,2004
697,Gulliver's Travels,237382724,42779261,18.0,194603463,82.0,2010
698,Gone in 60 Seconds,237202299,101648571,42.8,135553728,57.2,2000
699,Saturday Night Fever,237113184,94213184,39.7,142900000,60.3,1977
700,Silver Linings Playbook,236412453,132092958,55.9,104319495,44.1,2012
701,2 Fast 2 Furious,236350661,127154901,53.8,109195760,46.2,2003
702,Hidden Figures,235956898,169607287,71.9,66349611,28.1,2016
703,A.I. Artificial Intelligence,235926552,78616689,33.3,157309863,66.7,2001
704,Dead Poets Society,235860116,95860116,40.6,140000000,59.4,1989
705,Spy,235666219,110825712,47.0,124840507,53.0,2015
706,American Pie,235483004,102561004,43.6,132922000,56.4,1999
707,American Reunion,234989584,57011521,24.3,177978063,75.7,2012
708,Big Daddy,234801895,163479795,69.6,71322100,30.4,1999
709,Alvin and the Chipmunks: The Road Chip,234798636,85886987,36.6,148911649,63.4,2015
710,The Imitation Game,233555708,91125683,39.0,142430025,61.0,2014
711,Cruella,233503234,86103234,36.9,147400000,63.1,2021
712,The Day the Earth Stood Still,233093859,79366978,34.0,153726881,66.0,2008
713,American Wedding,232722935,104565114,44.9,128157821,55.1,2003
714,The Girl with the Dragon Tattoo,232617430,102515793,44.1,130101637,55.9,2011
715,Juno,232372681,143495265,61.8,88877416,38.2,2007
716,Argo,232325503,136025503,58.6,96300000,41.4,2012
717,Mr. Bean's Holiday,232225908,33302167,14.3,198923741,85.7,2007
718,The English Patient,231976425,78676425,33.9,153300000,66.1,1996
719,Sister Act,231605150,139605150,60.3,92000000,39.7,1992
720,Annabelle Comes Home,231252591,74152591,32.1,157100000,67.9,2019
721,Constantine,230884728,75976178,32.9,154908550,67.1,2005
722,Get Smart,230685453,130319208,56.5,100366245,43.5,2008
723,Space Jam,230594962,90594962,39.3,140000000,60.7,1996
724,Life Is Beautiful,230098753,57563264,25.0,172535489,75.0,1998
725,The Heat,229930771,159582188,69.4,70348583,30.6,2013
726,Ghostbusters,229147509,128350574,56.0,100796935,44.0,2016
727,Ghost Rider,228738393,115802596,50.6,112935797,49.4,2007
728,Goodbye Mr. Loser,228122928,1293626,0.6,226829302,99.4,2015
729,Paddington 2,227994792,40907738,17.9,187087054,82.1,2017
730,Sleepless in Seattle,227927165,126808165,55.6,101119000,44.4,1993
731,Lethal Weapon 2,227853986,147253986,64.6,80600000,35.4,1989
732,The Green Hornet,227817248,98780042,43.4,129037206,56.6,2011
733,Out of Africa,227514205,87071205,38.3,140443000,61.7,1985
734,Elf,227356156,178053220,78.3,49302936,21.7,2003
735,Youth,227091290,1891956,0.8,225199334,99.2,2017
736,Baby Driver,226945087,107825862,47.5,119119225,52.5,2017
737,Immortals,226904017,83504017,36.8,143400000,63.2,2011
738,Taken,226837760,145000989,63.9,81836771,36.1,2008
739,Percy Jackson & the Olympians: The Lightning Thief,226497209,88768303,39.2,137728906,60.8,2010
740,Lightyear,226425420,118307188,52.2,108118232,47.8,2022
741,Hansel & Gretel: Witch Hunters,226349749,55703475,24.6,170646274,75.4,2013
742,Valerian and the City of a Thousand Planets,225973340,41189488,18.2,184783852,81.8,2017
743,Good Will Hunting,225933435,138433435,61.3,87500000,38.7,1997
744,Better Days,225918798,1921657,0.8,223997141,99.2,2019
745,Ford v Ferrari,225508210,117624357,52.2,107883853,47.8,2019
746,Jumper,225132113,80172128,35.6,144959985,64.4,2008
747,The Social Network,224920375,96962694,43.1,127957681,56.9,2010
748,Chicken Run,224874811,106834564,47.5,118040247,52.5,2000
749,Con Air,224012234,101117573,45.1,122894661,54.9,1997
750,Interview with the Vampire: The Vampire Chronicles,223664608,105264608,47.1,118400000,52.9,1994
751,Flightplan,223387299,89707299,40.2,133680000,59.8,2005
752,Yes Man,223241637,97690976,43.8,125550661,56.2,2008
753,Non-Stop,222809600,92168600,41.4,130641000,58.6,2014
754,"Honey, I Shrunk the Kids",222724172,130724172,58.7,92000000,41.3,1989
755,Fahrenheit 9/11,222446882,119194771,53.6,103252111,46.4,2004
756,Wild Wild West,222104681,113804681,51.2,108300000,48.8,1999
757,"My Country, My Parents",221831086,177133,0.1,221653953,99.9,2021
758,Geostorm,221600160,33700160,15.2,187900000,84.8,2017
759,Presumed Innocent,221303188,86303188,39.0,135000000,61.0,1990
760,Jungle Cruise,220889446,116987516,53.0,103901930,47.0,2021
761,Scary Movie 3,220673217,110003217,49.8,110670000,50.2,2003
762,Collateral,220239925,101005703,45.9,119234222,54.1,2004
763,Inferno,220021259,34343574,15.6,185677685,84.4,2016
764,Knocked Up,219922417,148768917,67.6,71153500,32.4,2007
765,Green Lantern,219851172,116601172,53.0,103250000,47.0,2011
766,What Happens in Vegas,219375562,80277646,36.6,139097916,63.4,2008
767,It's Complicated,219103655,112735375,51.4,106368280,48.6,2009
768,The Terminal,219100084,77872883,35.5,141227201,64.5,2004
769,Little Women,218843645,108101214,49.4,110742431,50.6,2019
770,Captain Phillips,218791811,107100855,49.0,111690956,51.0,2013
771,The Prince of Egypt,218613188,101413188,46.4,117200000,53.6,1998
772,Jack Reacher,218340595,80070736,36.7,138269859,63.3,2012
773,Kingdom of Heaven,218122627,47398413,21.7,170724214,78.3,2005
774,The Emoji Movie,217776646,86089513,39.5,131687133,60.5,2017
775,Too Cool to Kill,217254604,185882,0.1,217068722,99.9,2022
776,Dracula Untold,217124280,56280355,25.9,160843925,74.1,2014
777,Central Intelligence,216972543,127440871,58.7,89531672,41.3,2016
778,Million Dollar Baby,216763646,100492203,46.4,116271443,53.6,2004
779,The Help,216639112,169708112,78.3,46931000,21.7,2011
780,Twins,216614388,111938388,51.7,104676000,48.3,1988
781,Valentine's Day,216528528,110528528,51.0,106000000,49.0,2010
782,Bad Teacher,216197492,100292856,46.4,115904636,53.6,2011
783,Smile,216135048,105935048,49.0,110200000,51.0,2022
784,A Little Red Flower,216000000,0,0.0,216000000,100.0,2020
785,The Croods: A New Age,215905815,58568815,27.1,157337000,72.9,2020
786,Clear and Present Danger,215887717,122187717,56.6,93700000,43.4,1994
787,One Hundred and One Dalmatians,215880014,144880014,67.1,71000000,32.9,1961
788,Ted 2,215863606,81476385,37.7,134387221,62.3,2015
789,Dracula,215862692,82522790,38.2,133339902,61.8,1992
790,Vertical Limit,215663859,69243859,32.1,146420000,67.9,2000
791,Ghostbusters II,215394738,112494738,52.2,102900000,47.8,1989
792,The Patriot,215294342,113330342,52.6,101964000,47.4,2000
793,The Sorcerer's Apprentice,215283742,63150991,29.3,152132751,70.7,2010
794,Just Go with It,214945591,103028109,47.9,111917482,52.1,2011
795,The Expendables 3,214657577,39322544,18.3,175335033,81.7,2014
796,Dirty Dancing,214577242,64577242,30.1,150000000,69.9,1987
797,Creed II,214215889,115715889,54.0,98500000,46.0,2018
798,Smallfoot,214115531,83315531,38.9,130800000,61.1,2018
799,Public Enemies,214104620,97104620,45.4,117000000,54.6,2009
800,The Bourne Identity,214034224,121661683,56.8,92372541,43.2,2002
801,Disclosure,214015089,83015089,38.8,131000000,61.2,1994
802,Pulp Fiction,213928762,107928762,50.4,106000000,49.6,1994
803,The Aviator,213719942,102610330,48.0,111109612,52.0,2004
804,"Crouching Tiger, Hidden Dragon",213525736,128078872,60.0,85446864,40.0,2000
805,Braveheart,213216216,75609945,35.5,137606271,64.5,1995
806,Into the Woods,212902372,128002372,60.1,84900000,39.9,2014
807,Bedtime Stories,212874864,110101975,51.7,102772889,48.3,2008
808,Miss Congeniality,212742720,106807667,50.2,105935053,49.8,2000
809,Entrapment,212404396,87704396,41.3,124700000,58.7,1999
810,Ace Ventura: When Nature Calls,212385533,108385533,51.0,104000000,49.0,1995
811,End of Days,211989043,66889043,31.6,145100000,68.4,1999
812,Bridget Jones's Baby,211952420,24252420,11.4,187700000,88.6,2016
813,Fury,211822697,85817906,40.5,126004791,59.5,2014
814,Battle Los Angeles,211819354,83552429,39.4,128266925,60.6,2011
815,Australia,211787511,49554002,23.4,162233509,76.6,2008
816,Due Date,211780824,100539043,47.5,111241781,52.5,2010
817,Master and Commander: The Far Side of the World,211622535,93927920,44.4,117694615,55.6,2003
818,A Series of Unfortunate Events,211468235,118634549,56.1,92833686,43.9,2004
819,The Little Mermaid,211343479,111543479,52.8,99800000,47.2,1989
820,Nice View,211019042,0,0.0,211019042,100.0,2022
821,District 9,210888950,115646235,54.8,95242715,45.2,2009
822,Moonraker,210308099,70308099,33.4,140000000,66.6,1979
823,The Others,209947037,96522687,46.0,113424350,54.0,2001
824,Horrible Bosses,209838559,117538559,56.0,92300000,44.0,2011
825,Us and Them,209221380,0,0.0,209221380,100.0,2018
826,Red Dragon,209196298,93149898,44.5,116046400,55.5,2002
827,Tomorrowland,209035668,93436322,44.7,115599346,55.3,2015
828,Me Before You,208314186,56245075,27.0,152069111,73.0,2016
829,Safe House,208076205,126373434,60.7,81702771,39.3,2012
830,S.W.A.T.,207725639,116934650,56.3,90790989,43.7,2003
831,The Fast and the Furious,207517509,144745925,69.8,62771584,30.2,2001
832,Traffic,207515725,124115725,59.8,83400000,40.2,2000
833,DC League of Super-Pets,207357117,93657117,45.2,113700000,54.8,2022
834,Paranormal Activity 3,207039844,104028807,50.2,103011037,49.8,2011
835,Philadelphia,206678440,77446440,37.5,129232000,62.5,1993
836,The Conjuring: The Devil Made Me Do It,206431050,65631050,31.8,140800000,68.2,2021
837,Sleepy Hollow,206071502,101071502,49.0,105000000,51.0,1999
838,The Holiday,205850169,63224849,30.7,142625320,69.3,2006
839,The Jungle Book,205843612,141843612,68.9,64000000,31.1,1967
840,Raging Fire,205842393,385305,0.2,205457088,99.8,2021
841,London Has Fallen,205754447,62524260,30.4,143230187,69.6,2016
842,The Break-Up,205668210,118703275,57.7,86964935,42.3,2006
843,Journey to the West,205637183,18058,0.1,205619125,100.0,2013
844,The Ugly Truth,205599393,88915214,43.2,116684179,56.8,2009
845,JFK,205405498,70405498,34.3,135000000,65.7,1991
846,Birds of Prey,205372791,84172791,41.0,121200000,59.0,2020
847,White House Down,205366737,73103784,35.6,132262953,64.4,2013
848,A Dog's Purpose,205035819,64508620,31.5,140527199,68.5,2017
849,Ponyo,204826668,15743471,7.7,189083197,92.3,2008
850,Fun with Dick and Jane,204681899,110332737,53.9,94349162,46.1,2005
851,Eat Pray Love,204594016,80574010,39.4,124020006,60.6,2010
852,The Addams Family,204394183,100723831,49.3,103670352,50.7,2019
853,Ghostbusters: Afterlife,204334455,129360575,63.3,74973880,36.7,2021
854,You Don't Mess with the Zohan,204313400,100018837,49.0,104294563,51.0,2008
855,Hairspray,203627753,118946291,58.4,84681462,41.6,2007
856,King Arthur,203567857,51882244,25.5,151685613,74.5,2004
857,Yogi Bear,203509374,100246011,49.3,103263363,50.7,2010
858,Everest,203427584,43482270,21.4,159945314,78.6,2015
859,Vanilla Sky,203388341,100618344,49.5,102769997,50.5,2001
860,Arrival,203388186,100546139,49.4,102842047,50.6,2016
861,Need for Speed,203277636,43577636,21.4,159700000,78.6,2014
862,Garfield,203172417,75369589,37.1,127802828,62.9,2004
863,Patch Adams,202292902,135026902,66.8,67266000,33.2,1998
864,Teenage Mutant Ninja Turtles,202084756,135384756,67.0,66700000,33.0,1990
865,Kindergarten Cop,201957688,91457688,45.3,110500000,54.7,1990
866,Straight Outta Compton,201634991,161197785,80.0,40437206,20.0,2015
867,21 Jump Street,201585328,138447667,68.7,63137661,31.3,2012
868,Valkyrie,201545517,83077833,41.2,118467684,58.8,2008
869,Open Season,200811689,85105259,42.4,115706430,57.6,2006
870,Cats & Dogs,200687492,93385515,46.5,107301977,53.5,2001
871,The Hunt for Red October,200512643,122012643,60.8,78500000,39.2,1990
872,Percy Jackson: Sea of Monsters,199850315,68559554,34.3,131290761,65.7,2013
873,Two Weeks Notice,199043471,93354851,46.9,105688620,53.1,2002
874,RED,199006387,90380162,45.4,108626225,54.6,2010
875,Shock Wave 2,198921659,0,0.0,198921659,100.0,2020
876,City of Angels,198685114,78685114,39.6,120000000,60.4,1998
877,The Pacifier,198636868,113086868,56.9,85550000,43.1,2005
878,50 First Dates,198520934,120908074,60.9,77612860,39.1,2004
879,Total Recall,198467168,58877969,29.7,139589199,70.3,2012
880,The Island,198326350,670883,0.3,197655467,99.7,2018
881,The Impossible,198087212,19019882,9.6,179067330,90.4,2012
882,Lost in Thailand,197757387,57387,0.1,197700000,100.0,2012
883,Christopher Robin,197744377,99215042,50.2,98529335,49.8,2018
884,Jack the Giant Slayer,197687603,65187603,33.0,132500000,67.0,2013
885,Smurfs: The Lost Village,197183546,45020282,22.8,152163264,77.2,2017
886,Chinese Doctors,197143218,0,0.0,197143218,100.0,2021
887,Spy Kids 3: Game Over,197101678,111761982,56.7,85339696,43.3,2003
888,Panic Room,197079546,96397334,48.9,100682212,51.1,2002
889,The Other Woman,196710396,83911193,42.7,112799203,57.3,2014
890,Stargate,196567262,71567262,36.4,125000000,63.6,1994
891,Beowulf,196393745,82280579,41.9,114113166,58.1,2007
892,The Vow,196114570,125014030,63.8,71100540,36.2,2012
893,Anger Management,195745823,135645823,69.3,60100000,30.7,2003
894,Tropic Thunder,195702963,110515313,56.5,85187650,43.5,2008
895,The Shape of Water,195333312,63859435,32.7,131473877,67.3,2017
896,Rocketman,195320400,96368160,49.3,98952240,50.7,2019
897,The Pelican Brief,195268056,100768056,51.6,94500000,48.4,1993
898,The BFG,195243411,55483770,28.4,139759641,71.6,2016
899,Downton Abbey,194694725,96853865,49.8,97840860,50.2,2019
900,The Intern,194564672,75764672,38.9,118800000,61.1,2015
901,The Curse of the Were-Rabbit,194137091,56110897,28.9,138026194,71.1,2005
902,Gnomeo & Juliet,193967670,99967670,51.5,94000000,48.5,2011
903,The Sum of All Fears,193921372,118907036,61.3,75014336,38.7,2002
904,Gangs of New York,193772504,77812000,40.2,115960504,59.8,2002
905,The Post,193764664,81903458,42.3,111861206,57.7,2017
906,The Monkey King 2,193678298,709982,0.4,192968316,99.6,2016
907,Paranormal Activity,193355800,107918810,55.8,85436990,44.2,2009
908,Weathering with You,193339746,8056636,4.2,185283110,95.8,2019
909,The Lego Movie 2: The Second Part,192456290,105956290,55.0,86500000,45.0,2019
910,The Equalizer,192330738,101530738,52.8,90800000,47.2,2014
911,Sheep Without a Shepherd,191602146,0,0.0,191602146,100.0,2019
912,The Addams Family,191502426,113502426,59.3,78000000,40.7,1991
913,The Longest Yard,191466556,158119460,82.6,33347096,17.4,2005
914,The Lost City,190844029,105344029,55.2,85500000,44.8,2022
915,The Santa Clause,190539357,145539357,76.4,45000000,23.6,1994
916,Cheaper by the Dozen,190538630,138614544,72.8,51924086,27.2,2003
917,The Equalizer 2,190400157,102084362,53.6,88315795,46.4,2018
918,Abominable,190304772,61270390,32.2,129034382,67.8,2019
919,Hollow Man,190213455,73209340,38.5,117004115,61.5,2000
920,Outbreak,189859560,67659560,35.6,122200000,64.4,1995
921,The White Storm 2: Drug Lords,189396380,609461,0.3,188786919,99.7,2019
922,The X Files,189176423,83898313,44.4,105278110,55.6,1998
923,Breakup Buddies,189017596,777896,0.4,188239700,99.6,2014
924,Rambo III,189015611,53715611,28.4,135300000,71.6,1988
925,The Secret Life of Walter Mitty,188133322,58236838,31.0,129896484,69.0,2013
926,Project Gutenberg,188116796,0,0.0,188116796,100.0,2018
927,Jaws 2,187884007,81766007,43.5,106118000,56.5,1978
928,12 Years a Slave,187733202,56671993,30.2,131061209,69.8,2013
929,Heat,187436818,67436818,36.0,120000000,64.0,1995
930,Mr. Popper's Penguins,187361754,68224452,36.4,119137302,63.6,2011
931,The Grudge,187281115,110359362,58.9,76921753,41.1,2004
932,One Piece Film: Red,187170070,12775324,6.8,174394746,93.2,2022
933,I Now Pronounce You Chuck & Larry,187134117,120059556,64.2,67074561,35.8,2007
934,The Horse Whisperer,186883563,75383563,40.3,111500000,59.7,1998
935,Walk the Line,186797986,119519402,64.0,67278584,36.0,2005
936,Jian Bing Man,186699768,0,0.0,186699768,100.0,2015
937,The Jungle Book 2,186303759,47901582,25.7,138402177,74.3,2003
938,The Final Destination,186167139,66477700,35.7,119689439,64.3,2009
939,Atlantis: The Lost Empire,186053725,84056472,45.2,101997253,54.8,2001
940,Inside Man,186003591,88513495,47.6,97490096,52.4,2006
941,The Waterboy,185991646,161491646,86.8,24500000,13.2,1998
942,Hugo,185770310,73864507,39.8,111905803,60.2,2011
943,Pitch Perfect 3,185400345,104897530,56.6,80502815,43.4,2017
944,Watchmen,185382813,107509799,58.0,77873014,42.0,2009
945,The Birdcage,185260553,124060553,67.0,61200000,33.0,1996
946,Moulin Rouge!,184935320,57386607,31.0,127548713,69.0,2001
947,Snow White and the Seven Dwarfs,184925486,184925486,100.0,0,0.0,1937
948,Hop,184367145,108498305,58.8,75868840,41.2,2011
949,Bad Moms,183936074,113257297,61.6,70678777,38.4,2016
950,Jupiter Ascending,183887723,47387723,25.8,136500000,74.2,2015
951,Knowing,183658498,79957634,43.5,103700864,56.5,2007
952,102 Dalmatians,183611771,66957026,36.5,116654745,63.5,2000
953,Storks,183510278,72800603,39.7,110709675,60.3,2016
954,Stand by Me Doraemon,183442714,0,0.0,183442714,100.0,2014
955,The Hitman's Bodyguard,183428689,75468583,41.1,107960106,58.9,2017
956,Paul Blart: Mall Cop,183348429,146336178,79.8,37012251,20.2,2009
957,Wayne's World,183097323,121697323,66.5,61400000,33.5,1992
958,Maverick,183031272,101631272,55.5,81400000,44.5,1994
959,Mirror Mirror,183018522,64935167,35.5,118083355,64.5,2012
960,The Man in the Iron Mask,182968902,56968902,31.1,126000000,68.9,1998
961,Cape Fear,182291969,79091969,43.4,103200000,56.6,1991
962,The Haunted Mansion,182290266,75847266,41.6,106443000,58.4,2003
963,The Monkey King Havoc in Heavens Palace,182206924,0,0.0,182206924,100.0,2014
964,While You Were Sleeping,182057016,81057016,44.5,101000000,55.5,1995
965,The Bridges of Madison County,182016617,71516617,39.3,110500000,60.7,1995
966,From Vegas to Macau III,181732879,0,0.0,181732879,100.0,2016
967,Poseidon,181674817,60674817,33.4,121000000,66.6,2006
968,The First Wives Club,181489203,105489203,58.1,76000000,41.9,1996
969,Cliff Walkers,181325565,152972,0.1,181172593,99.9,2021
970,Scooby-Doo 2: Monsters Unleashed,181239132,84239132,46.5,97000000,53.5,2004
971,Hot Shots!,181096164,69467617,38.4,111628547,61.6,1991
972,Road to Perdition,181001478,104454762,57.7,76546716,42.3,2002
973,Kill Bill: Vol. 1,180906076,70099045,38.8,110807031,61.2,2003
974,The Scorpion King,180630907,91047077,50.4,89583830,49.6,2002
975,Sweet Home Alabama,180622424,127223418,70.4,53399006,29.6,2002
976,Daddy's Home 2,180613824,104029443,57.6,76584381,42.4,2017
977,Hacksaw Ridge,180563636,67209615,37.2,113354021,62.8,2016
978,Deja Vu,180557550,64038616,35.5,116518934,64.5,2006
979,Dangerous Minds,179519401,84919401,47.3,94600000,52.7,1995
980,The Dictator,179379533,59650222,33.2,119729311,66.8,2012
981,The League of Extraordinary Gentlemen,179265204,66465204,37.1,112800000,62.9,2003
982,Allegiant,179246868,66184051,36.9,113062817,63.1,2016
983,Daredevil,179179718,102543518,57.2,76636200,42.8,2003
984,City Slickers,179033791,124033791,69.3,55000000,30.7,1991
985,He's Just Not That Into You,178866158,93953653,52.5,84912505,47.5,2009
986,Eagle Eye,178767383,101440743,56.7,77326640,43.3,2008
987,Along Came Polly,178311729,88097164,49.4,90214565,50.6,2004
988,Flushed Away,178281554,64665672,36.3,113615882,63.7,2006
989,Scary Movie 4,178262620,90710620,50.9,87552000,49.1,2006
990,Dante's Peak,178127760,67127760,37.7,111000000,62.3,1997
991,Brokeback Mountain,178062759,83043761,46.6,95018998,53.4,2005
992,Patriot Games,178051587,83351587,46.8,94700000,53.2,1992
993,Flubber,177977226,92977226,52.2,85000000,47.8,1997
994,Baywatch,177856751,58060186,32.6,119796565,67.4,2017
995,Double Jeopardy,177841558,116741558,65.6,61100000,34.4,1999
996,War Horse,177584879,79884879,45.0,97700000,55.0,2011
997,Paranormal Activity 2,177512032,84752907,47.7,92759125,52.3,2010
998,How to Lose a Guy in 10 Days,177502387,105813373,59.6,71689014,40.4,2003
999,Alien vs. Predator,177427090,80282231,45.2,97144859,54.8,2004
1000,Hero,177395557,53710019,30.3,123685538,69.7,2002
1001,The 40-Year-Old Virgin,177378645,109449237,61.7,67929408,38.3,2005
1002,The Butler,177313795,116632095,65.8,60681700,34.2,2013
1003,The Haunting,177311151,91411151,51.6,85900000,48.4,1999
1004,The Descendants,177243185,82584160,46.6,94659025,53.4,2011
1005,The A-Team,177238796,77222099,43.6,100016697,56.4,2010
1006,Tootsie,177200271,177200000,100.0,271,0.0,1982
1007,In the Line of Fire,176997168,102314823,57.8,74682345,42.2,1993
1008,Analyze This,176885658,106885658,60.4,70000000,39.6,1999
1009,Looper,176506819,66486205,37.7,110020614,62.3,2012
1010,Serial (Bad) Weddings,176404493,0,0.0,176404493,100.0,2014
1011,Ip Man 4: The Finale,176345966,3956031,2.2,172389935,97.8,2019
1012,Dr. Dolittle 2,176104344,112952899,64.1,63151445,35.9,2001
1013,The Italian Job,176070171,106128601,60.3,69941570,39.7,2003
1014,The Bucket List,175372502,93466502,53.3,81906000,46.7,2007
1015,Sleeping with the Enemy,174999005,101599005,58.1,73400000,41.9,1991
1016,Cowboys & Aliens,174822325,100240551,57.3,74581774,42.7,2011
1017,The Mule,174804407,103804407,59.4,71000000,40.6,2018
1018,George of the Jungle,174463257,105263257,60.3,69200000,39.7,1997
1019,Evan Almighty,174440724,100462298,57.6,73978426,42.4,2007
1020,Amélie,174122191,33225499,19.1,140896692,80.9,2001
1021,Identity Thief,173965010,134506920,77.3,39458090,22.7,2013
1022,The Nutcracker and the Four Realms,173961069,54858851,31.5,119102218,68.5,2018
1023,Big Momma's House,173959438,117559438,67.6,56400000,32.4,2000
1024,In Time,173930596,37520095,21.6,136410501,78.4,2011
1025,Operation Mekong,173839072,800012,0.5,173039060,99.5,2016
1026,Anchorman 2: The Legend Continues,173649931,127352707,73.3,46297224,26.7,2013
1027,Creed,173578883,109778883,63.2,63800000,36.8,2015
1028,Gemini Man,173469516,48546770,28.0,124922746,72.0,2019
1029,The Girl on the Train,173185859,75395035,43.5,97790824,56.5,2016
1030,The Grand Budapest Hotel,173082189,59301324,34.3,113780865,65.7,2014
1031,Scream,173046663,103046663,59.6,70000000,40.4,1996
1032,Cold Mountain,173013509,95636509,55.3,77377000,44.7,2003
1033,Black Hawk Down,172989651,108638745,62.8,64350906,37.2,2001
1034,The Santa Clause 2,172855065,139236327,80.6,33618738,19.4,2002
1035,Cloverfield,172394180,80048433,46.4,92345747,53.6,2008
1036,Scream 2,172363301,101363301,58.8,71000000,41.2,1997
1037,Couples Retreat,171844840,109204945,63.6,62639895,36.4,2009
1038,Antz,171757863,90757863,52.8,81000000,47.2,1998
1039,Blood Diamond,171720398,57377916,33.4,114342482,66.6,2006
1040,Jackass 3D,171685792,117229692,68.3,54456100,31.7,2010
1041,No Country for Old Men,171627434,74283625,43.3,97343809,56.7,2007
1042,Spies in Disguise,171616764,66757013,38.9,104859751,61.1,2019
1043,John Wick: Chapter 2,171547802,92029184,53.6,79518618,46.4,2017
1044,Cocktail,171504781,78222753,45.6,93282028,54.4,1988
1045,Chinese Zodiac,171339013,0,0.0,171339013,100.0,2012
1046,Mr. Deeds,171269535,126293452,73.7,44976083,26.3,2002
1047,Nope,171235592,123277080,72.0,47958512,28.0,2022
1048,Contact,171120329,100920329,59.0,70200000,41.0,1997
1049,Superbad,170812526,121463226,71.1,49349300,28.9,2007
1050,The Other Guys,170458922,119219978,69.9,51238944,30.1,2010
1051,The Specialist,170362582,57362582,33.7,113000000,66.3,1994
1052,Olympus Has Fallen,170270201,98925640,58.1,71344561,41.9,2013
1053,Starsky & Hutch,170268750,88237754,51.8,82030996,48.2,2004
1054,Shall We Dance,170128460,57890460,34.0,112238000,66.0,2004
1055,Princess Mononoke,170005875,4845631,2.8,165160244,97.2,1999
1056,Stuart Little 2,169956806,64956806,38.2,105000000,61.8,2002
1057,Zookeeper,169852759,80360843,47.3,89491916,52.7,2011
1058,Ghost in the Shell,169846945,40563557,23.9,129283388,76.1,2017
1059,Dumb and Dumber To,169837010,86208010,50.8,83629000,49.2,2014
1060,Seven Pounds,169748929,69951824,41.2,99797105,58.8,2008
1061,The Emperor's New Groove,169662207,89636687,52.8,80025520,47.2,2000
1062,Wonder Woman 1984,169601036,46801036,27.6,122800000,72.4,2020
1063,Meet the Robinsons,169333034,97822171,57.8,71510863,42.2,2007
1064,12 Monkeys,168839459,57141459,33.8,111698000,66.2,1995
1065,The Suicide Squad,168717425,55817425,33.1,112900000,66.9,2021
1066,Dodgeball: A True Underdog Story,168423227,114326736,67.9,54096491,32.1,2004
1067,Hellboy II: The Golden Army,168319243,75986503,45.1,92332740,54.9,2008
1068,Ticket to Paradise,168094863,68275985,40.6,99818878,59.4,2022
1069,Insidious: The Last Key,167885588,67745330,40.4,100140258,59.6,2018
1070,Fantastic Four,167882881,56117548,33.4,111765333,66.6,2015
1071,Unstoppable,167805466,81562942,48.6,86242524,51.4,2010
1072,Three Men and a Baby,167780960,167780960,100.0,0,0.0,1987
1073,Morbius,167460961,73865530,44.1,93595431,55.9,2022
1074,Alexander,167298192,34297191,20.5,133001001,79.5,2004
1075,Magic Mike,167282206,113781613,68.0,53500593,32.0,2012
1076,Up in the Air,166842739,83823381,50.2,83019358,49.8,2009
1077,Jujutsu Kaisen 0: The Movie,166745261,34542754,20.7,132202507,79.3,2021
1078,Nutty Professor II: The Klumps,166339890,123309890,74.1,43030000,25.9,2000
1079,Sleepers,165615285,53315285,32.2,112300000,67.8,1996
1080,Bridge of Spies,165478348,72313754,43.7,93164594,56.3,2015
1081,The Princess Diaries,165335153,108248956,65.5,57086197,34.5,2001
1082,The Muppets,165184237,88631237,53.7,76553000,46.3,2011
1083,The Huntsman: Winter's War,164989338,48390190,29.3,116599148,70.7,2016
1084,Saw III,164874275,80238724,48.7,84635551,51.3,2006
1085,Six Days Seven Nights,164839294,74339294,45.1,90500000,54.9,1998
1086,Bringing Down the House,164729679,132716677,80.6,32013002,19.4,2003
1087,Deep Blue Sea,164648142,73648142,44.7,91000000,55.3,1999
1088,Speed 2: Cruise Control,164508066,48608066,29.6,115900000,70.4,1997
1089,Daddy Day Care,164433867,104297061,63.4,60136806,36.6,2003
1090,The Spiderwick Chronicles,164170327,71195053,43.4,92975274,56.6,2008
1091,The Pink Panther,164115897,82226474,50.1,81889423,49.9,2006
1092,Four Christmases,164112721,120146040,73.2,43966681,26.8,2008
1093,The Ring Two,163995949,76231249,46.5,87764700,53.5,2005
1094,From Vegas to Macau II,163877532,0,0.0,163877532,100.0,2015
1095,Miami Vice,163794509,63450470,38.7,100344039,61.3,2006
1096,Burn After Reading,163728902,60355347,36.9,103373555,63.1,2008
1097,Space Jam: A New Legacy,163692228,70592228,43.1,93100000,56.9,2021
1098,Pokémon: The First Movie - Mewtwo Strikes Back,163644662,85744662,52.4,77900000,47.6,1999
1099,The Happening,163403799,64506874,39.5,98896925,60.5,2008
1100,Talladega Nights: The Ballad of Ricky Bobby,163362095,148213377,90.7,15148718,9.3,2006
1101,World Trade Center,163247198,70278893,43.0,92968305,57.0,2006
1102,The Island,162949164,35818913,22.0,127130251,78.0,2005
1103,The Interpreter,162944923,72708161,44.6,90236762,55.4,2005
1104,"Three Billboards Outside Ebbing, Missouri",162861289,54513740,33.5,108347549,66.5,2017
1105,Dick Tracy,162738726,103738726,63.8,59000000,36.2,1990
1106,27 Dresses,162655351,76808654,47.2,85846697,52.8,2008
1107,The Magnificent Seven,162360636,93432655,57.6,68927981,42.4,2016
1108,Eyes Wide Shut,162243224,55691208,34.3,106552016,65.7,1999
1109,Memoirs of a Geisha,162242962,57490508,35.4,104752454,64.6,2005
1110,Jack Reacher: Never Go Back,162146076,58697076,36.2,103449000,63.8,2016
1111,Insidious: Chapter 2,161919318,83586447,51.6,78332871,48.4,2013
1112,Limitless,161849455,79249455,49.0,82600000,51.0,2011
1113,Scream 3,161834276,89143175,55.1,72691101,44.9,2000
1114,Flight,161772375,93772375,58.0,68000000,42.0,2012
1115,Payback,161626121,81526121,50.4,80100000,49.6,1999
1116,Into the Storm,161515959,47615959,29.5,113900000,70.5,2014
1117,Unbroken,161459297,115637895,71.6,45821402,28.4,2014
1118,The Black Phone,161440742,90123230,55.8,71317512,44.2,2022
1119,Alien: Resurrection,161376069,47795658,29.6,113580411,70.4,1997
1120,The Hateful Eight,161217616,54117416,33.6,107100200,66.4,2015
1121,The Sacrifice,161047608,0,0.0,161047608,100.0,2020
1122,Born on the Fourth of July,161001698,70001698,43.5,91000000,56.5,1989
1123,Freaky Friday,160846332,110230332,68.5,50616000,31.5,2003
1124,Legends of the Fall,160638883,66638883,41.5,94000000,58.5,1994
1125,The Predator,160542134,51024708,31.8,109517426,68.2,2018
1126,Johnny English,160466000,28082366,17.5,132383634,82.5,2003
1127,The War of the Roses,160188546,86888546,54.2,73300000,45.8,1989
1128,Underworld: Awakening,160112671,62321039,38.9,97791632,61.1,2012
1129,Lara Croft Tomb Raider: The Cradle of Life,160099222,65660196,41.0,94439026,59.0,2003
1130,Johnny English Reborn,160078586,8305970,5.2,151772616,94.8,2011
1131,Alien³,159814498,55473545,34.7,104340953,65.3,1992
1132,Norbit,159814490,95673607,59.9,64140883,40.1,2007
1133,21,159808370,81159365,50.8,78649005,49.2,2008
1134,Stepmom,159710793,91137662,57.1,68573131,42.9,1998
1135,The Sound of Music,159428329,159287539,99.9,140790,0.1,1965
1136,The Jackal,159330280,54930280,34.5,104400000,65.5,1997
1137,Step Up 3D,159291809,42400223,26.6,116891586,73.4,2010
1138,Daylight,159212469,33023469,20.7,126189000,79.3,1996
1139,Happy Feet Two,159197038,64006466,40.2,95190572,59.8,2011
1140,Unforgiven,159167799,101167799,63.6,58000000,36.4,1992
1141,Johnny English Strikes Again,158972499,4412170,2.8,154560329,97.2,2018
1142,The Fast and the Furious: Tokyo Drift,158964610,62514415,39.3,96450195,60.7,2006
1143,Focus,158762963,53862963,33.9,104900000,66.1,2015
1144,Sin City,158733820,74103820,46.7,84630000,53.3,2005
1145,Goosebumps,158261424,80080379,50.6,78181045,49.4,2015
1146,Days of Thunder,157920733,82670733,52.4,75250000,47.6,1990
1147,Final Destination 5,157887643,42587643,27.0,115300000,73.0,2011
1148,RRR,157832163,14843467,9.4,142988696,90.6,2022
1149,Don't Breathe,157761002,89217875,56.6,68543127,43.4,2016
1150,Hustlers,157563598,104963598,66.6,52600000,33.4,2019
1151,Crimson Tide,157387195,91387195,58.1,66000000,41.9,1995
1152,The Matrix Resurrections,157286805,37686805,24.0,119600000,76.0,2021
1153,The Book of Eli,157107755,94835059,60.4,62272696,39.6,2010
1154,Ip Man 3,157029618,2679437,1.7,154350181,98.3,2015
1155,The Climbers,156892866,487157,0.3,156405709,99.7,2019
1156,P.S. I Love You,156846321,53706790,34.2,103139531,65.8,2007
1157,The Monuments Men,156706638,78031620,49.8,78675018,50.2,2014
1158,Mystic River,156595191,90135191,57.6,66460000,42.4,2003
1159,Under Siege,156563139,83563139,53.4,73000000,46.6,1992
1160,This Means War,156491279,54760791,35.0,101730488,65.0,2012
1161,Licence to Kill,156167015,34667015,22.2,121500000,77.8,1989
1162,The Sting,156000000,156000000,100.0,0,0.0,1973
1163,Rocky Balboa,155929020,70270943,45.1,85658077,54.9,2006
1164,Escape Room,155712077,57005601,36.6,98706476,63.4,2019
1165,Hannah Montana: The Movie,155545279,79576189,51.2,75969090,48.8,2009
1166,Monster-in-Law,155457327,82931301,53.4,72526026,46.6,2005
1167,Dreamgirls,155430335,103365956,66.5,52064379,33.5,2006
1168,The Accountant,155160045,86260045,55.6,68900000,44.4,2016
1169,Bayside Shakedown 2,155138312,0,0.0,155138312,100.0,2003
1170,Blade II,155010032,82348319,53.1,72661713,46.9,2002
1171,Maid in Manhattan,154906693,94011225,60.7,60895468,39.3,2002
1172,Cool Runnings,154856263,68856263,44.5,86000000,55.5,1993
1173,Lone Survivor,154802912,125095601,80.8,29707311,19.2,2013
1174,The Phantom of the Opera,154674241,51293931,33.2,103380310,66.8,2004
1175,Yesterday,154608717,73286650,47.4,81322067,52.6,2019
1176,Ride Along,154468902,134938200,87.4,19530702,12.6,2014
1177,Kill Bill: Vol. 2,154117157,66208183,43.0,87908974,57.0,2004
1178,The Town,154026136,92186262,59.8,61839874,40.2,2010
1179,Peter Rabbit 2: The Runaway,153901717,40501717,26.3,113400000,73.7,2021
1180,Gremlins,153898890,153642180,99.8,256710,0.2,1984
1181,Free Willy,153709806,77709806,50.6,76000000,49.4,1993
1182,Another 48 Hrs.,153518974,80818974,52.6,72700000,47.4,1990
1183,Sweeney Todd: The Demon Barber of Fleet Street,153383627,52898073,34.5,100485554,65.5,2007
1184,House of Gucci,153268899,53809574,35.1,99459325,64.9,2021
1185,Monkey King: Hero Is Back,153262397,0,0.0,153262397,100.0,2015
1186,The Devil's Advocate,152944660,60944660,39.8,92000000,60.2,1997
1187,Tower Heist,152930623,78046570,51.0,74884053,49.0,2011
1188,Duckweed,152894264,471575,0.3,152422689,99.7,2017
1189,Chocolat,152699976,71509363,46.8,81190613,53.2,2000
1190,Backdraft,152368585,77868585,51.1,74500000,48.9,1991
1191,A Time to Kill,152266007,108766007,71.4,43500000,28.6,1996
1192,Date Night,152263880,98711404,64.8,53552476,35.2,2010
1193,Vantage Point,152039882,72266306,47.5,79773576,52.5,2008
1194,Phenomenon,152036382,104636382,68.8,47400000,31.2,1996
1195,Congo,152022101,81022101,53.3,71000000,46.7,1995
1196,Surf's Up,152005713,58867694,38.7,93138019,61.3,2007
1197,Big,151927281,115227281,75.8,36700000,24.2,1988
1198,Jackass Presents: Bad Grandpa,151826547,102003019,67.2,49823528,32.8,2013
1199,47 Ronin,151783839,38362475,25.3,113421364,74.7,2013
1200,Midnight in Paris,151672318,56817045,37.5,94855273,62.5,2011
